20
      # ###                                                            /###           /                     
    /  /###  /                                                        /  ############/                      
   /  /  ###/                                                        /     ##########                       
  /  ##   ##                                                         #             /                        
 /  ###                                                               ##          /                         
##   ##     ###  /###     /###     /###     /###   ##   ####                     /         /###     /###    
##   ##      ###/ #### / / ###  / / #### / / #### / ##    ###  /                /         / ###  / / ###  / 
##   ##       ##   ###/ /   ###/ ##  ###/ ##  ###/  ##     ###/                /         /   ###/ /   ###/  
##   ##       ##       ##    ## ####     ####       ##      ##                /         ##    ## ##    ##   
##   ##       ##       ##    ##   ###      ###      ##      ##               /          ##    ## ##    ##   
 ##  ##       ##       ##    ##     ###      ###    ##      ##              /           ##    ## ##    ##   
  ## #      / ##       ##    ##       ###      ###  ##      ##             /            ##    ## ##    ##   
   ###     /  ##       ##    ##  /###  ## /###  ##  ##      ##         /##/           / ##    ## ##    ##   
    ######/   ###       ######  / #### / / #### /    #########        /  ############/   ######   ######    
      ###      ###       ####      ###/     ###/       #### ###      /     ##########     ####     ####     
                                                             ###                                            
                                                      #####   ###                                           
                                                    /#######  /#                                            
                                                   /      ###/                                              