.........................................................................................
:'######::::::'###::::'##::::'##:'########:::::'#######::'##::::'##:'########:'########::
'##... ##::::'## ##::: ###::'###: ##.....:::::'##.... ##: ##:::: ##: ##.....:: ##.... ##:
 ##:::..::::'##:. ##:: ####'####: ##:::::::::: ##:::: ##: ##:::: ##: ##::::::: ##:::: ##:
 ##::'####:'##:::. ##: ## ### ##: ######:::::: ##:::: ##: ##:::: ##: ######::: ########::
 ##::: ##:: #########: ##. #: ##: ##...::::::: ##:::: ##:. ##:: ##:: ##...:::: ##.. ##:::
 ##::: ##:: ##.... ##: ##:.:: ##: ##:::::::::: ##:::: ##::. ## ##::: ##::::::: ##::. ##::
. ######::: ##:::: ##: ##:::: ##: ########::::. #######::::. ###:::: ########: ##:::. ##:
:......::::..:::::..::..:::::..::........::::::.......::::::...:::::........::..:::::..::