 ________  ________  _________  ___  ________  ________      
|\   __  \|\   __  \|\___   ___\\  \|\   __  \|\   ___  \    
\ \  \|\  \ \  \|\  \|___ \  \_\ \  \ \  \|\  \ \  \\ \  \   
 \ \  \\\  \ \   ____\   \ \  \ \ \  \ \  \\\  \ \  \\ \  \  
  \ \  \\\  \ \  \___|    \ \  \ \ \  \ \  \\\  \ \  \\ \  \ 
   \ \_______\ \__\        \ \__\ \ \__\ \_______\ \__\\ \__\
    \|_______|\|__|         \|__|  \|__|\|_______|\|__| \|__|