..........................................................................................
'##::::'##:'####::'######::'########::'#######::'########::'##:::'##::::'####:'####:'####:
 ##:::: ##:. ##::'##... ##:... ##..::'##.... ##: ##.... ##:. ##:'##::::: ####: ####: ####:
 ##:::: ##:: ##:: ##:::..::::: ##:::: ##:::: ##: ##:::: ##::. ####:::::: ####: ####: ####:
 ##:::: ##:: ##:: ##:::::::::: ##:::: ##:::: ##: ########::::. ##:::::::: ##::: ##::: ##::
. ##:: ##::: ##:: ##:::::::::: ##:::: ##:::: ##: ##.. ##:::::: ##::::::::..::::..::::..:::
:. ## ##:::: ##:: ##::: ##:::: ##:::: ##:::: ##: ##::. ##::::: ##:::::::'####:'####:'####:
::. ###::::'####:. ######::::: ##::::. #######:: ##:::. ##:::: ##::::::: ####: ####: ####:
:::...:::::....:::......::::::..::::::.......:::..:::::..:::::..::::::::....::....::....::